


C 58,126,153

F 71,40,45
SO ./textures/water.xpm
WE ./textures/lava.xpm
EA ./textures/stone.xpm
NO ./textures/wood.xpm

11111111111111111111111111111111
10001000000001000010001000000001    1111
1000100000000000001000100000111     101
1000000010000000011000100011         1
10000000101100000010001000001111111
1111011111100000010000100010001
    100010110000000E00100000000111111
1111000010110000000000111111000100001
11111111111111100000011     111111111
               1111111