C 58,126,153

F 71,40,45
SO ./textures/water.xpm
EA ./textures/stone.xpm
NO ./textures/wood.xpm
WE ./textures/lava.xpm

111111111111111111111111
100000000000000000000001
100000000000000000000001
100000000000000010000001
100000000000000010000001
1000000000000000D00000W1
100000000000000010000001
111111111111111111111111