


C 97,215,219

F 51,102,0
SO ./textures/metal_wall2.xpm
WE ./textures/metal_wall.xpm
EA ./textures/stone_wall.xpm
NO ./textures/wood_wall.xpm

              111
             11011
            1100011
          11100000111
        111000000000111
      1110000000000000111    
    11100000000100000000111
  111000000000000000000000111
 11000000000010N01000000000011
  110000000000000000000000111
    11100000000100000000111
      1110000000000000111
        111000000000111
          1110000111
            1100011
             11011
              111